11111111111111111111111111111111
11111111111111111111111111111111
11111111111111111111111111111111
111111111E00000000000C0111111111
11111111111111101101111111111111
1111111110000H000000000111111111
111111111C00C1101100000111111111
111111111000000V00011P1111111111
11111111111111111111111111111111
11111111111111111111111111111111
11111111111111111111111111111111